NO ../wolftex/pics/greystone.png
SO ../wolftex/pics/colorstone.png
WE ../wolftex/pics/purplestone.png
EA ../wolftex/pics/redbrick.png

F 220,100,0
C 225,30,0

OOOOOOOOOOOOOOOOOOOOOOOOOOOOOOOOOOO
O        1111111111111111111111111O
O        1000000000110000000000001O
O        1011000001110000000000001O
O        1001000000000000000000001O
O111111111011000001110000000000001O
O100000000011000001110111111111111O
O11110111111111011100000010001    O
O11110111111111011101010010001    O
O11000000110101011100000010001    O
O10000000000000001100000010001    O
O10000000000000001101010010001    O
O11000001110101011111011110N0111  O
O11110111 1110101 101111010001    O
O11111111 1111111 111111111111    O
OOOOOOOOOOOOOOOOOOOOOOOOOOOOOOOOOOO